1111111111111111
1000000001000011
1111000001000011
110000N000001111
1000000000000011
1111111111111111